* * * * * * * * * * * * * * * 0 8 0 17 0 17 0 17 0 17 0 17 0 17 0 17 0 17 0 17 0 17 0 17 0 17 0 17 0 17 0 17 0 17 0 17 0 17 0 19 * * * * * * * 0 15 0 17 0 17 0 17 * * * * * * * * * * * * * * *
* * * * * * * * * * * * * * * 0 17 0 17 0 17 0 17 0 17 0 17 0 17 0 17 0 17 0 17 0 17 0 17 0 17 0 17 0 17 0 17 0 17 0 17 0 17 0 19 * * * * * * * 0 15 0 17 0 17 0 17 * * * * * * * * * * * * * * *
* * * * * * * * * * * * * * * 0 17 0 17 0 17 0 17 0 17 0 17 0 17 0 17 0 4 0 5 0 17 0 17 0 17 0 17 0 17 0 17 0 4 0 5 0 4 0 5 * * * * * * * 0 15 0 17 0 17 0 17 * * * * * * * * * * * * * * *
* * * * * * * * * * * * * * * 0 17 0 17 0 17 0 17 0 17 0 17 0 17 0 17 0 6 0 7 0 17 0 19 * * * * 0 6 0 7 0 6 0 7 * * * * * * * 0 15 0 17 0 17 0 17 * * * * * * * * * * * * * * *
* * * * * * * * * * * * * * * 0 17 0 17 0 17 0 17 0 19 * * * * * * * * * * * * * * * * * * * * * * 0 15 0 17 0 17 0 17 0 17 * * * * * * * * * * * * * *
* * * * * * * * 0 17 0 17 0 17 0 17 0 17 0 17 0 17 0 17 0 17 0 17 0 17 0 19 * * * * * * * * * * * * * * * * * * * * * * 0 15 0 17 0 17 0 17 0 17 * * * * * * * * * * * * * *
* * * * * * * * 0 17 0 17 0 17 0 17 0 17 0 17 0 17 0 17 0 17 0 17 0 8 0 19 * * * * * * * * * * * * * * * * * * * * * * 0 15 0 17 0 17 0 17 0 17 * * * * * * * * * * * * * *
0 17 0 17 0 17 0 17 0 17 0 17 0 17 0 17 0 17 0 17 0 17 0 17 0 17 0 17 0 17 0 17 0 17 0 17 0 17 0 19 * * * * * * * * * * * * * * * * * * * * * * 0 15 0 17 0 17 0 17 0 17 * * * * * * * * * * * * * *
0 17 0 17 0 17 0 17 0 17 0 17 0 17 0 17 0 17 0 17 0 19 * * * 0 15 0 17 0 17 0 17 0 8 0 17 0 21 0 16 0 16 0 8 0 16 0 23 * * * * * * * * * * * * * * * * * 0 15 0 17 0 17 0 17 0 17 * * * * * * * * * * * * *
0 17 0 17 0 17 0 17 0 17 0 17 0 8 0 17 0 17 0 19 * * * * 0 8 0 17 0 17 0 17 0 17 0 17 0 17 0 17 0 17 0 17 0 17 0 19 * * * 0 22 0 16 0 4 0 5 * * * * * * * * * * 0 15 0 17 0 17 0 17 0 17 0 17 0 17 0 17 * * * * * * * * * *
0 17 0 17 0 17 0 17 0 17 0 17 0 17 0 17 0 17 0 19 * * * * 0 8 0 17 0 17 0 17 0 17 0 17 0 17 0 17 0 17 0 17 0 17 0 8 * * * 0 15 0 17 0 6 0 7 * * * * * * * * * * 0 4 0 5 0 17 0 17 0 17 0 17 0 17 0 17 * * 1 46 1 47 * * * * * *
0 17 0 17 0 17 0 17 0 19 * * * * * * * * * 0 15 0 17 0 17 0 17 0 17 0 17 0 8 0 17 0 17 0 17 0 8 0 8 * * * * * * 0 8 0 4 0 5 * * * * * * * * 0 6 0 7 0 17 0 17 0 17 0 17 1 46 1 47 * * 1 54 1 55 0 4 0 5 * * * *
0 17 0 17 0 17 0 17 0 19 * * * * * * * * * 0 15 0 17 0 17 0 17 0 17 0 17 0 17 0 17 0 17 0 19 * * * * * * * * * 0 6 0 7 * * * * * * * * 0 15 0 17 0 17 0 17 0 17 0 17 1 54 1 55 0 4 0 5 1 53 * 0 6 0 7 * * * *
0 17 0 17 0 17 0 17 0 19 * * * * * * * 0 8 0 8 0 8 0 17 0 4 0 5 0 17 0 17 0 8 0 17 0 17 0 19 * * * * * * * * * * 0 8 * * * * * * * * 0 15 0 17 0 8 0 8 0 17 0 8 0 8 1 53 0 6 0 7 0 8 * * 0 8 1 46 1 47 0 8 *
0 17 0 17 0 8 0 17 0 19 * * * * * * * * * * 0 15 0 6 0 7 0 17 0 17 0 17 0 17 0 17 0 17 0 21 0 23 * * * * 0 22 0 23 * * 0 8 0 8 0 23 * * * * * * * * * * * * * * * * * * 0 8 1 53 1 54 1 55 1 46 1 47
0 17 0 17 0 17 0 17 0 17 0 21 0 16 0 8 0 16 0 23 * * * * * * 0 15 0 17 0 17 0 17 0 4 0 5 0 17 0 17 0 17 0 19 * * * * 0 15 0 19 * * 0 15 0 17 0 19 * * * * * * * * * * * * * * * * * * 1 53 0 8 0 4 0 5 1 54 1 55
0 17 0 17 0 17 0 4 0 5 0 17 0 17 0 17 0 17 0 8 0 23 * * * * * 0 15 0 17 0 17 0 17 0 6 0 7 0 17 0 17 0 17 0 17 0 21 0 16 0 16 0 20 0 17 0 19 * * 0 15 0 17 0 17 0 21 0 23 * * * * * * * * * * * * * * * * 0 4 0 5 0 6 0 7 * *
0 17 0 17 0 17 0 6 0 7 0 17 0 17 0 17 0 17 0 17 0 19 * * * * * * * * * * * * * * * * * * * * * * * 0 15 0 8 0 19 * * * * * * * * * * * * * * * * * * 0 6 0 7 0 8 * * *
0 17 0 17 0 17 0 17 0 17 0 17 0 17 0 17 0 17 0 17 0 19 * * * * * * * * * * * * * * * * * * * * * * * * 0 8 * * * * * * 0 4 0 5 0 16 0 8 0 16 0 16 0 16 0 8 0 16 0 16 0 4 0 5 1 46 1 47 1 53 * 0 4 0 5 *
0 17 0 17 0 17 0 17 0 17 0 17 0 17 0 17 0 17 0 17 0 19 * * * * * * * * * * * * * * * * * * * * * * * * * * * * * * * 0 6 0 7 0 17 0 17 0 17 0 17 0 17 0 17 0 4 0 5 0 6 0 7 1 54 1 55 0 4 0 5 0 6 0 7 *
* * * * * * 0 17 0 17 0 17 0 17 0 17 0 21 0 16 0 8 0 16 0 16 0 16 0 16 0 16 0 16 0 16 0 16 0 16 0 16 0 16 0 16 0 16 0 23 * * * * * * * * * * * * 0 22 0 16 0 8 0 17 0 17 0 17 0 17 0 8 0 17 0 17 0 6 0 7 0 8 1 46 1 47 1 53 0 6 0 7 * * *
* * * * * * 0 17 0 17 0 17 0 17 0 17 0 17 0 17 0 17 0 17 0 17 0 17 0 17 0 17 0 17 0 17 0 17 0 17 0 19 * * * * * * * * * * * * * * * * 0 15 0 17 0 17 0 17 0 17 0 17 0 8 0 17 0 17 0 17 0 17 0 17 * 1 54 1 55 0 8 * * * * *
* * * * * * 0 17 0 17 0 17 0 17 0 17 0 17 0 17 0 17 0 17 0 17 0 17 0 17 0 17 0 17 0 17 0 17 0 8 0 8 * * * * * * * * * * * * * * * * 0 15 0 17 0 17 0 17 0 17 0 17 0 17 0 17 0 17 1 53 0 17 0 17 * * * * * * * * *
* * * * * * 0 17 0 17 0 17 0 17 0 17 0 17 0 17 0 17 0 17 0 17 0 17 0 17 0 4 0 5 0 17 0 17 0 17 0 19 * * * * * * * * * * 0 8 0 16 0 16 0 8 0 16 0 20 0 17 0 17 0 17 0 17 0 17 0 17 * * * * * * * * * * * * * * *
* * * * * * * * * * * * * 0 17 0 17 0 17 0 17 0 17 0 6 0 7 * * * * * * * * * * * * 0 4 0 5 0 17 0 17 0 17 0 17 0 17 0 17 0 4 0 5 0 17 0 17 0 17 * * * * * * * * * * * * * * * *
* * * * * * * * * * * * * 0 17 0 17 0 17 0 17 0 19 * * * * * * * * * * * * 0 22 0 8 0 6 0 7 0 17 0 17 0 17 0 17 0 17 0 17 0 6 0 7 0 17 0 17 0 17 * * * * * * * * * * * * * * * *
* * * * * * * * * * * * * 0 17 0 17 0 17 0 17 0 19 * * * * * * * * * * * * 0 15 0 17 0 17 0 17 0 17 0 17 0 17 0 17 0 17 0 17 0 17 0 17 0 17 0 17 0 17 * * * * * * * * * * * * * * * *
* * * * * * * * * * * * * 0 17 0 8 0 17 0 17 0 19 * * * * * * * * * * 0 22 0 20 0 17 0 17 0 17 0 17 0 17 0 17 0 17 0 17 0 17 0 17 0 17 0 17 0 17 0 17 0 17 * * * * * * * * * * * * * * * *
* * * * * * * * * * * * * 0 17 0 17 0 17 0 17 0 8 * * * * * * * * * * 0 15 0 17 0 17 0 17 0 17 0 17 0 17 0 17 * * * * * * * * * * * * * * * * * * * * * * * * *
* * * * * * * * * * * * * 0 17 0 17 0 17 0 17 0 19 * * * * * * * * 0 22 0 20 0 17 0 17 0 17 0 17 0 17 0 8 0 17 * * * * * * * * * * * * * * * * * * * * * * * * * *
* * * * * * * * * * * * * 0 17 0 17 0 8 0 17 0 17 0 21 0 4 0 5 0 16 0 8 0 16 0 16 0 16 0 8 0 17 0 17 0 17 0 17 0 17 0 17 * * * * * * * * * * * * * * * * * * * * * * * * * * * *
* * * * * * * * * * * * * 0 4 0 5 0 17 0 17 0 17 0 17 0 6 0 7 0 17 0 17 0 17 0 17 0 17 0 17 0 17 0 17 0 17 0 17 0 17 0 17 * * * * * * * * * * * * * * * * * * * * * * * * * * * *
* * * * * * * * * * * * * 0 6 0 7 0 8 0 17 0 17 0 17 0 17 0 17 0 17 0 17 0 17 0 17 0 8 0 17 0 17 0 17 0 17 0 17 * * * * * * * * * * * * * * * * * * * * * * * * * * * * * *
* * * * * * * * * * * * * 0 17 0 17 0 17 0 17 0 17 0 17 0 17 0 17 0 17 0 17 0 17 0 17 0 17 0 17 0 17 0 17 0 17 0 17 * * * * * * * * * * * * * * * * * * * * * * * * * * * * * *
