* * * * * * * * * * * * * * * * * * * * * * * * * * * * * * * * * * * * * *
* * * * * * * * * * * * * * * * * * * * * * * * * * * * * * * * * * * * * *
* * * * * * * * * * * * * * * * * * * 0 24 0 24 0 24 * * * * * * * * * * * * * * * *
* * * * * * * * * * * * * * * * * * 0 24 0 24 0 24 0 24 0 24 * * * * * * * * * * * * * * *
* * * 0 24 0 24 0 24 * * * * * * * * * * * 0 26 0 27 0 24 0 24 0 97 0 24 * * * * * * * * * * * * * * *
* * * 0 24 0 24 0 24 0 24 0 24 * * * * * * * * * 0 28 0 31 0 24 0 24 0 24 0 24 * * * * * * * * * * * * * * *
* * 0 24 0 24 0 24 0 24 0 24 0 24 0 24 * * * * * * * * 0 32 0 33 0 24 0 24 0 24 0 24 * * * * * * * * * * * * * * *
* * 0 24 0 24 0 24 0 24 0 24 0 24 0 43 0 44 * * * * * * * 0 34 0 35 0 24 0 24 0 24 0 24 * * * * * * * * * * * * * * *
* * 0 24 0 24 0 24 0 24 0 24 0 24 0 45 0 46 * * * * * * * * 0 24 0 24 0 24 0 24 * * * * * * * * * * * * * * * *
* * 0 24 0 24 0 24 0 24 0 24 0 24 0 47 0 48 * * * * * * * * * 0 24 0 24 0 24 * * * * * * * * * * * * * * * *
* * 0 24 0 24 0 24 0 24 0 24 0 24 0 49 0 50 * * * * * * * * * * * * * * * * * 0 24 0 24 0 24 0 24 0 24 0 24 0 24 * * * *
* * 0 24 0 24 0 24 0 24 0 24 0 24 0 24 * * * * * * * * * * * * * * * * 0 24 0 24 0 24 0 24 0 24 0 24 0 24 0 24 0 24 0 24 * * *
* * * 0 24 0 24 0 24 0 24 0 24 0 24 * * * * * * * * * * * * * 0 24 0 24 0 24 0 24 0 24 0 24 0 24 0 24 0 24 0 24 0 24 0 24 0 24 0 24 * *
* * * 0 24 0 24 0 24 0 24 * * * * * * * * * * * * * 0 24 0 24 0 24 0 24 0 24 0 24 0 24 0 24 0 24 0 24 0 24 0 24 0 24 0 24 0 24 0 24 * *
* * * * * * * * * * * * * * * * * 0 93 0 94 0 24 0 24 0 24 0 24 0 24 0 24 * * 0 24 0 24 0 24 0 24 0 24 0 24 0 24 0 24 0 24 * *
* * * * * * * * * * * * * * * * * 0 93 0 94 0 24 0 82 0 83 0 83 0 83 0 84 0 24 0 24 0 24 0 24 0 24 0 24 0 24 0 24 0 24 0 24 0 24 * *
* * * * * * * * * * * * * 0 97 0 97 0 97 0 97 0 98 0 99 0 85 0 86 0 87 0 87 0 87 0 88 0 94 0 24 0 24 0 24 0 24 0 24 0 24 0 24 0 24 0 24 0 24 * *
* * * * * * * * * * * * * 0 101 0 101 0 101 0 101 0 102 0 24 0 90 0 91 * * * 0 93 0 94 0 24 0 24 0 24 0 24 0 24 0 24 0 24 0 24 0 24 0 24 * *
* * * * * * * * * * * * * * * * * * * 0 24 0 24 0 24 * * 0 93 0 94 0 24 0 24 0 24 0 24 0 24 0 24 0 24 0 24 0 24 0 24 * *
* * * * * * * * * * * * * * * * * * * 0 24 0 24 0 24 * * 0 93 0 94 0 24 0 24 0 24 0 24 0 24 0 24 0 24 0 24 0 24 0 24 * *
* * * * * * * * * * * * * * * * * * * * 0 24 0 24 0 24 0 24 0 93 0 94 0 24 0 24 0 24 0 24 0 24 0 24 0 24 0 24 0 24 * * *
* * * * * * * * * * * * * * * * * * * * * 0 24 0 24 0 24 0 93 0 94 0 24 0 24 0 24 0 24 0 24 0 24 0 24 0 24 * * * *
* * * * * * * * * * * * * * * * * * * * * * 0 24 0 24 0 24 0 24 0 24 * 0 24 0 24 0 24 0 24 0 24 * * * * *
* * * * * * * * * * * * * * * * * * * * * * 0 24 0 24 0 24 0 24 0 24 0 24 0 24 0 24 0 24 * * * * * * *
* * * * * * * * * * * * * * * * * * * * * * * 0 24 0 24 0 24 0 24 0 24 0 24 0 24 * * * * * * * *
* * * * * * * * * * * * * * * * * * * * * * * * * * * 0 24 0 24 * * * * * * * * *
