0 22 0 16 0 16 0 23 * * * * * * * * * * * * * * * * * * * * * * * * * * * * * * * * * * * * * * 0 22 0 16 0 63 0 64 * * * * * * * * * * * * * * * * * * * * * * *
0 15 0 17 0 17 0 19 * * * * * * * * * * * * * * * * * * * * * * * * * * * * * * * * * * * * * * 0 15 0 17 0 17 0 68 0 63 0 64 * * * * * * * * * * * * * * * * * * * * *
0 15 0 17 * * * * * * * * * * * * * * * * * * * * * * * * * * * * * * * * * * * * * * * * 0 4 0 5 0 17 0 17 0 17 0 68 0 23 * * * * * * * * * * * * * * * * * * * *
0 15 0 8 * * * * * * * * * * * * * * * * * * * * * * * * * * * * * * * * * * * * * * * * 0 6 0 7 0 17 0 17 0 17 0 17 0 19 * * * * * * * * * * * * * * * 0 22 0 16 0 16 0 16 0 16
0 4 0 5 * * * * * * * * * * * * * * * * * * * * * * * * * * * * * * * * * * * * * * * * * * * * * * * * * * * * * * * * * * * * * * 0 15 0 17 0 17 0 17 0 17
0 6 0 7 * * * * * * * * * * * * * * * * * * * * * * * * * * 0 22 0 16 0 16 0 16 0 4 0 5 0 70 * * * * * * * * * * * * * * * * * * * * * * * * * * * * * 0 15 0 4 0 5 0 17 0 17
0 8 0 8 0 4 0 5 * * * * * * * * * * * * * * * * * * * * * * * * 0 15 0 17 0 17 0 17 0 6 0 7 0 75 0 70 * * * * * * * * * * * * * * * * * 0 22 0 23 * * * * * * * * * 0 8 0 6 0 7 0 17 0 17
* 0 8 0 6 0 7 * * * * * * * * * * * * * * * * * * * * * * 0 8 0 4 0 5 0 17 0 17 0 17 0 17 0 8 0 4 0 5 0 70 * * * * * * * * * * * * * * * * 0 15 0 17 0 8 0 8 0 23 * * * * * * 0 15 0 17 0 17 0 17 0 17
* 0 22 0 16 0 8 0 16 0 23 * * * * * * * * * * * * * * * * * * * * 0 8 0 6 0 7 0 17 0 17 0 17 0 17 0 8 0 6 0 7 0 8 0 70 * * 0 61 0 62 0 16 0 16 0 16 0 16 0 16 0 16 0 16 0 23 * * * * * * * * * * * * * * 0 15 0 17 0 17 0 17 0 17
* 0 15 0 17 0 8 0 17 0 19 * * * * * * * * * * * * * * * * * * * * * * 0 8 0 17 0 17 0 17 0 17 0 17 0 4 0 5 0 16 0 16 0 16 0 16 0 65 0 17 0 8 0 8 0 17 0 17 0 4 0 5 * * * * * * * * * * * * * * 0 4 0 5 0 8 0 8 0 17 0 17 0 17
* * 0 8 0 17 0 17 0 17 0 21 0 16 0 16 0 16 0 16 0 16 0 8 0 16 0 16 0 8 0 16 0 16 0 16 0 16 0 73 * * * * * * * 0 4 0 5 0 17 0 17 0 17 0 17 0 6 0 7 0 17 0 17 0 17 0 17 0 6 0 7 0 17 0 17 0 17 0 17 0 6 0 7 * * * * * * * * * * * * 0 22 0 16 0 6 0 7 0 17 0 17 0 17 0 17 0 17
* * 0 15 0 17 0 17 0 4 0 5 0 17 0 17 0 17 0 17 0 17 0 17 0 17 0 17 0 17 0 17 0 17 0 17 0 17 0 78 0 79 * * * * * 0 22 0 6 0 7 0 8 0 8 0 8 0 17 0 8 0 8 0 17 0 17 0 17 0 8 0 8 0 17 0 17 0 8 * * * * * * * * * * * * * * * 0 61 0 15 0 17 0 17 0 8 0 17 0 17 0 17 0 17 0 17
* * 0 15 0 8 0 8 0 6 0 7 0 17 0 17 0 17 0 17 0 17 0 17 0 17 0 17 0 17 0 17 0 17 0 17 0 17 0 17 0 19 * * * * * 0 15 0 17 0 17 0 17 0 17 0 17 0 17 0 8 0 8 0 17 0 17 0 17 0 8 0 8 0 17 0 17 0 19 * * * * * * * * 0 72 0 16 0 16 0 16 0 16 0 16 0 16 0 65 0 17 0 17 0 17 0 8 0 17 0 17 0 17 0 17 0 17
* * 0 15 0 8 0 17 0 17 0 17 0 17 0 17 0 17 0 17 0 4 0 5 0 17 0 17 0 8 0 17 0 17 0 17 0 17 0 17 0 19 * * * * * * * * * * * * * * * * * * * * * * * * * * * * * 0 76 0 77 0 15 0 17 0 17 0 17 0 17 0 17 0 17 0 17 0 17 0 17 0 8 0 17 0 17 0 17 0 17 0 17
* * * * * * * 0 15 0 17 0 17 0 17 0 6 0 7 0 17 0 8 0 17 0 17 0 17 0 17 0 17 0 17 0 17 0 21 0 73 * * * * * * * * * * * * * * * * * * * * * * * * * * 0 76 0 77 0 17 0 17 0 17 0 17 0 17 0 17 0 17 0 17 0 17 0 17 0 17 0 8 0 8 * * * *
* * * * * * * * 0 15 0 17 0 17 0 17 0 17 0 17 0 17 0 17 0 17 0 17 0 17 0 17 0 4 0 5 0 17 0 17 0 79 * * * * * * * * * * * * * * * * * * * * * 0 22 0 16 0 16 0 16 0 81 0 17 0 17 0 17 0 4 0 5 0 8 0 17 0 17 0 17 0 17 0 17 0 17 * * * * * *
* * * * * * * * * 0 15 0 17 0 17 0 17 0 17 0 17 0 17 0 17 0 17 0 17 0 17 0 6 0 7 0 17 0 17 0 78 0 79 * * * * * * * * * * * * * * * * * * * * 0 15 0 17 0 17 0 17 0 17 0 17 0 17 0 8 0 6 0 7 0 8 0 17 0 17 * * * * * * * * * *
* * * * * * * * * * * * * * * * 0 17 0 17 0 17 0 17 0 17 0 17 0 17 0 17 0 17 0 80 0 16 0 16 0 23 * * * * * * * * * * * * * * 0 4 0 5 0 20 0 17 0 17 0 17 0 17 0 17 0 17 0 17 0 17 0 17 0 17 0 17 * * * * * * * * * * * *
* * * * * * * * * * * * * * * * * 0 17 0 17 0 17 0 17 0 17 0 17 0 4 0 5 0 17 0 17 0 17 0 8 0 16 0 16 0 23 * * * * * * * * 0 22 0 16 0 16 0 6 0 7 0 19 0 4 0 5 0 8 0 17 0 17 0 17 0 17 0 17 0 17 0 17 0 17 * * * * * * * * * * * *
* * * * * * * * * * * * * * * * * * 0 17 0 17 0 17 0 17 0 17 0 6 0 7 0 4 0 5 0 17 0 17 0 4 0 5 0 19 * * * * * 0 22 0 16 0 4 0 5 0 17 0 17 0 17 0 17 0 8 0 6 0 7 0 8 0 17 0 17 * * * * * * * * * * * * * * * * * *
* * * * * * * * * * * * * * * * * * * 0 17 0 17 0 17 0 17 0 17 0 17 0 6 0 7 0 17 0 17 0 6 0 7 0 19 * * * * * * 0 8 0 6 0 7 0 17 0 17 0 17 0 17 0 17 0 17 0 17 0 17 0 17 0 17 * * * * * * * * * * * * * * * * * *
* * * * * * * * * * * * * * * * * * * 0 17 0 17 0 17 0 17 0 17 0 17 0 17 0 17 0 17 0 17 0 17 0 8 0 8 0 8 0 8 * * * * 0 15 0 17 0 17 0 4 0 5 0 4 0 5 0 17 0 17 0 17 0 17 * * * * * * * * * * * * * * * * * * * *
* * * * * * * * * * * * * * * * * * * 0 17 0 17 0 17 0 17 0 17 0 17 0 17 0 17 0 17 0 17 0 17 0 17 0 19 * * * * * * 0 15 0 17 0 17 0 6 0 7 0 6 0 7 0 17 0 17 * * * * * * * * * * * * * * * * * * * * * *
* * * * * * * * * * * * * * * * * * * 0 17 0 17 0 17 0 17 0 17 0 17 0 17 0 17 0 17 0 17 0 17 0 17 0 19 * * * * * * 0 15 0 17 0 17 0 17 0 4 0 5 * * * * * * 1 9 1 67 1 68 1 69 1 11 * * * * * * * * * * * * * *
* * * * * * * * 0 17 0 17 0 17 0 17 0 17 0 17 0 17 0 17 0 17 0 17 0 17 0 17 0 17 0 17 0 17 0 8 0 8 0 17 0 17 0 17 0 8 0 17 0 17 0 19 * * * * 0 22 0 20 0 17 0 17 0 17 0 17 0 6 0 7 * * * * 0 8 * 1 9 1 67 1 68 1 69 1 11 1 46 1 47 * * * * * * * * * * * *
* * * * * * * * 0 17 0 17 0 17 0 17 0 17 0 17 0 17 0 17 0 17 0 17 0 17 0 17 0 17 0 17 0 17 0 4 0 5 * * * * * 0 15 0 19 * * * * * 0 15 0 17 0 17 0 17 0 17 0 17 * * * * 0 8 1 53 1 53 1 9 1 67 1 68 1 69 1 11 1 54 0 8 * 0 4 0 5 * * * * * * * * *
* * * * * * * * 0 17 0 17 0 17 0 17 0 8 0 17 0 17 0 17 0 17 0 17 0 17 0 17 0 17 0 17 0 17 0 6 0 7 * * * * * 0 15 0 19 * * * * * * 0 15 0 17 0 8 0 17 0 17 * * * * 1 0 1 1 1 1 1 17 1 82 1 83 1 84 1 16 1 1 1 1 1 2 0 6 0 7 * * * * * * * * *
* * * * * * * * 0 17 0 17 0 8 0 4 0 5 * * * * * * * * * * * * * * * * * 0 15 0 17 0 21 0 23 * * * * 0 15 0 8 0 8 0 17 0 17 0 17 0 17 * 1 1 1 17 * * * * * * * * * 1 11 0 8 * * * * * * * * * *
* * * * * * * * 0 17 0 17 0 17 0 6 0 7 * * * * * * * * * * * * * * * * * * 0 53 * * * * * * * * * * * * * * * * * * * * * * * * * 1 11 1 53 0 8 * * * * * * * * *
* * * * * * * * 0 17 0 17 0 17 0 8 0 8 * * * * * * * * * * * * * * * * * * 0 53 * * * * * * * * * * * * * * * * * * * * * * * * * 1 11 0 8 1 53 * * * * * * * * *
* * * * * * * * 0 17 0 17 0 17 0 4 0 5 * * * * * 0 15 0 17 0 17 0 4 0 5 * * * * * * * * 0 53 * * * 0 22 0 8 0 20 0 17 0 17 0 4 0 5 0 8 * 0 17 * 1 19 1 8 * * * * * * * * * 1 11 1 53 * * * * * * * * * *
* * * * * * * * 0 17 0 17 0 17 0 6 0 7 0 16 0 16 0 8 0 16 0 20 0 17 0 17 0 17 0 6 0 7 0 4 0 5 * * * * * * 0 53 * * * 0 15 0 8 0 8 0 17 0 17 0 6 0 7 0 17 0 17 * 0 4 0 5 1 18 1 19 1 19 1 8 1 59 1 60 1 61 1 7 1 19 1 19 1 20 0 4 0 5 * * * * * * * * *
* * * * * * * * 0 17 0 8 0 17 0 17 0 8 0 17 0 17 0 17 0 17 0 17 0 17 0 17 0 17 0 17 0 17 0 6 0 7 0 16 0 16 0 16 0 16 0 8 0 16 0 8 0 8 0 16 0 20 0 17 0 17 0 17 0 17 0 17 0 17 0 17 0 17 * * 0 6 0 7 * 0 8 1 53 1 9 1 75 1 76 1 77 1 11 * 1 53 * 0 6 0 7 * * * * * * * * *
* * * * * * * * 0 17 0 17 0 17 0 17 0 17 0 17 0 17 0 17 0 4 0 5 0 17 0 17 0 17 0 17 0 17 0 17 0 17 0 17 0 17 0 17 0 17 0 17 0 17 0 4 0 5 0 17 0 17 0 17 0 8 0 17 0 17 0 17 0 17 0 17 0 17 * * * * * * * 1 9 1 75 1 76 1 77 1 11 * 0 8 1 53 * * * * * * * * * * *
* * * * * * * * 0 17 0 17 0 17 0 17 0 17 0 17 0 17 0 17 0 6 0 7 0 17 0 17 0 17 0 17 0 17 0 17 0 17 0 17 0 8 0 17 0 17 0 17 0 17 0 6 0 7 0 17 0 17 0 17 0 17 0 17 0 17 0 17 0 17 0 17 0 17 * * * * * * * 1 9 1 75 1 76 1 77 1 11 * * * * * * * * * * * * * *
* * * * * * * * 0 17 0 17 0 17 0 17 0 17 0 17 0 17 0 17 0 17 0 17 0 17 0 17 0 17 0 17 0 17 0 17 0 17 0 17 0 8 0 17 0 17 0 17 0 17 0 4 0 5 0 17 0 17 0 17 0 17 0 17 0 17 0 17 0 17 0 17 0 17 * * * * * * * * * * * * * * * * * * * * * * * * * *
* * * * * * * * * * * * * * * * * * * * 0 17 0 17 0 17 0 17 0 17 0 17 0 8 0 17 0 17 0 17 0 17 0 6 0 7 0 17 0 17 0 17 0 17 0 17 0 17 0 17 0 17 0 17 0 17 * * * * * * * * * * * * * * * * * * * * * * * * * *
