* * * * * * * * * * * * * * * * * * * * * * * * * *
* * * * * * * * * * * * * * * * * * * * * * * * * *
* * * * * * * * * * * * * * * * * * * * * * * * * *
* * * * * * * * * * * * * * * * * * * * * * * * * *
* * * * * * * * * * * * * * * * * * * * * * * * * *
* * * * * * * * * * * * * * * * * * * * * * * * * *
* * * * * * * * 0 1 0 0 0 1 0 2 0 3 0 18 0 18 * * * * * * * * * * *
* * * * * * * 0 2 0 3 0 2 0 3 0 0 0 1 0 18 0 18 * * 0 24 0 24 * * * * * * *
* * * * * * * 0 0 0 1 0 18 0 0 0 2 0 3 0 0 0 1 0 2 * * 0 24 * * * * * * *
* * * * * * * 0 2 0 3 0 18 0 2 0 3 0 18 0 2 0 3 0 18 0 18 * * * * * * * * *
* * * * * * * * * * * * * * 0 0 0 1 0 0 0 1 * * * * * * * *
* * * * * * * * * * * * * * * 0 3 0 2 0 3 0 18 * * * * * * *
* * * * * * * * * 0 24 0 24 0 24 0 24 * * * 0 18 0 0 0 1 0 18 0 0 0 1 * * * *
* * * * * * * 0 24 0 24 0 24 0 24 0 24 0 24 0 24 * * * 0 2 0 3 0 18 0 2 0 3 0 0 0 1 * *
* * * * * 0 24 0 24 0 24 0 24 0 24 0 24 0 24 0 24 0 24 0 24 * * * 0 18 0 0 0 1 0 18 0 2 0 3 * *
* * * 0 24 0 24 0 24 0 24 0 24 0 24 0 24 0 24 0 24 0 24 0 24 0 24 0 24 0 24 * * 0 2 0 3 0 18 0 18 0 18 * *
* * 0 24 0 24 0 24 0 24 * * * * * * * * * * * * * * * 0 18 0 0 0 1 * *
* * 0 24 0 24 0 24 * * 0 1 0 18 0 0 0 1 0 18 0 18 0 0 0 1 0 18 0 0 0 1 0 18 0 18 0 0 0 1 0 2 0 3 * *
* * 0 24 0 24 0 24 * * 0 3 0 0 0 2 0 3 0 0 0 1 0 2 0 3 0 0 0 2 0 3 0 0 0 1 0 2 0 3 0 18 * * *
* * * 0 24 0 24 * * 0 18 0 2 0 3 0 18 0 2 0 3 0 18 0 18 0 2 0 3 0 18 0 2 0 3 0 18 0 18 * * * *
* * * 0 24 0 24 * * * * * * * * * * * * * * * * * * * * *
* * * 0 24 0 24 * * * * * * * * * * * * * * * * * * * * *
* * * 0 24 0 24 0 24 * * * * * * * * * * * * * * * * * * * *
* * * 0 24 0 24 * * * * * * * * * * * * * * * * * * * * *
* * * * * * * * * * * * * * * * * * * * * * * * * *
* * * * * * * * * * * * * * * * * * * * * * * * * *
