* * * * * * * * * * * * * * * * * * * * * * * * * * * * * * * * *
* * * * * * * * * * * * * * * * * * * * * * * * * * * * * * * * *
* * * * * * * * * * * * * * * * * * * * * * * * * * * * * * * * *
* * * * * * * * * * * * * * * * * * * * * * * * * * * * * * * * *
* * * * * * * * * * * * * * * * * * * * * * * * * * * * * * * * *
* * * * * * * * * * * * * * * * * * * * * * * * * * * * * * * * *
* * * * * * * * * * * * * * * 0 10 0 10 0 10 * * * * * * * * * * * * * * *
* * * * * * * * * * * * * * * 0 27 0 28 0 29 * * * * * * * * * * * * * * *
* * * * * * * * * * * * * * * 0 10 0 10 0 10 * * * * * * * * * * * * * * *
* * * * * * * * * * * * * * * 0 27 0 28 0 29 * * * * * * * * * * * * * * *
* * * * * * * * * * * * * * * 0 10 0 10 0 10 * * * * * * * * * * * * * * *
* * * * * * * * * * * * * * * 0 27 0 28 0 29 * * * * * * * * * * * * * * *
* * * * * * * * * * * * * * * 0 10 0 10 0 10 * * * * * * * * * * * * * * *
* * * * * * * * * * * * * * * 0 27 0 28 0 29 * * * * * * * * * * * * * * *
* * * * * * * * * * * * * * * 0 10 0 10 0 10 * * * * * * * * * * * * * * *
* * * * * * * * * * * * * * * 0 27 0 28 0 29 * * * * * * * * * * * * * * *
* * * * * * * * * * * * * * * 0 10 0 10 0 10 * * * * * * * * * * * * * * *
* * * * * * * * * * * * * * * 0 27 0 28 0 29 * * * * * * * * * * * * * * *
* * * * * * * * * * * * * * * 0 10 0 10 0 10 * * * * * * * * * * * * * * *
* * * * * * * * * * * * * * * 0 27 0 28 0 29 * * * * * * * * * * * * * * *
* * * * * * * * * * * * * * * 0 10 0 10 0 10 * * * * * * * * * * * * * * *
* * * * * * * * * * * * * * * 0 27 0 28 0 29 * * * * * * * * * * * * * * *
* * * * * * * * * * * * * * * 0 10 0 10 0 10 * * * * * * * * * * * * * * *
* * * * * * * * * * * * * * * 0 27 0 28 0 29 * * * * * * * * * * * * * * *
* * * * * * * * * * * * * * * 0 10 0 10 0 10 * * * * * * * * * * * * * * *
* * * * * * * * * * 0 52 * 0 51 * * 0 27 0 28 0 29 * * 0 52 * 0 51 * * * * * * * * * *
* * * * * * * * * * 0 52 * 0 51 * * 0 10 0 10 0 10 * * 0 52 * 0 51 * * * * * * * * * *
* * * * * * * * * * 0 52 * 0 51 * * 0 27 0 28 0 29 * * 0 52 * 0 51 * * * * * * * * * *
* * * * * * * * * * 0 52 * 0 51 * * 0 10 0 10 0 10 * * 0 52 * 0 51 * * * * * * * * * *
* * * * * * * * * * * * * * * 0 27 0 28 0 29 * * * * * * * * * * * * * * *
* * * * * * * * * * * * * * * * * * * * * * * * * * * * * * * * *
* * * * * * * * * * * * * * * * * * * * * * * * * * * * * * * * *
* * * * * * * * * * * * * * * * * * * * * * * * * * * * * * * * *
* * * * * * * * * * * * * * * * * * * * * * * * * * * * * * * * *
* * * * * * * * * * * * * * * * * * * * * * * * * * * * * * * * *
